11111111111111111111111111111111111111111
10000000000000000000000000000000000000001
1000P00000000000000000000000000C000000011
10000000000000000000000000000000000000001
10000000000000000000000000000000000000001
10000000000000000000000000000000000000001
11000000000000000000000000000000000000001
10000000000000000000000000000000000000001
1000C000000000000000000000000001110000111
111111100000000000E0000000000001000000001
11111111111111111111111111111111111111110
