11111111111111111111111111111111111111111
100000C00000010C00000000000000000000C0001
10000000000000000000000000000000000000001
1C000000000000000000000000000000000000001
100000000000010000000P0000000000000000001
1100000C000011000000000000000000000000001
100000000000000000000000000000000000000C1
10000000000000000000000000000000000000001
10000C00000000000000000000000000000000001
10000000000000000000E0000000000000C000001
11111111111111111111111111111111111111111